NO ./ressources/north.xpm
WE ./ressources/west.xpm
EA ./ressources/east.xpm





C 10,90,250
F 34,139,35
SO ./ressources/south.xpm

11111111111
11111000111
11111011111
11111011111
11111011111
11111N11111
11111111111