NO ./ressources/west.xpm
SO ./ressources/south.xpm
WE ./ressources/north.xpm
EA ./ressources/east.xpm

C 10,90,250
F 34,139,35

11111111111
11111011111
11111011111
11111011111
11111011111
11111S11111
11111111111