NO ./ressources/north.xpm
SO ./ressources/south.xpm
WE ./ressources/west.xpm
EA ./ressources/east.xpm

C 10,90,250
F 34,139,35


    1111111111111
    1001111000001
    1001E11011
100111111000110
100111100000110
100111100000110
100111100000110
100111100000110
100111100000110
1111111111111