NO ./ressources/north.xpm
WE ./ressources/west.xpm
EA ./ressources/east.xpm





C 10,90,250
F 34,139,35
SO ./ressources/south.xpm

11111111111
11000000111
11000000111
11000000111
11000000111
11000000111
11000000111
11111000111
11111000001111111111111
11111000000000000011111
1111111111111110011111
11111000000000000011111
11111000000000000011111
11111N00000000000000011111
11111111111111111111111111