NO ./ressources/north.xpm
SO ./ressources/south.xpm
WE ./ressources/west.xpm
EA ./ressources/east.xpm
C 225,69,100

F 220,90,60




111111111111
100000000001
100000000001
10000N000001
100000000001
111111111111
