NO ./ressources/north.xpm
SO ./ressources/south.xpm
WE ./ressources/west.xpm
EA ./ressources/east.xpm

C 225,69,100
F 220,90,60

  111111111111111111111111
  100000000000000000000001
  100000000000000000000001
  100000000000000000000001
  100000111110000101010001
  100000100010000000000001
  100000100010000100010001
  100000100010000000000001
  100000110110000101010001
  100000000000000000000001
  100000000000000000000001
  100000000000011110000001
  100000000001100000000001
  1000001100000N0000000001
  100000000000000000000001
  100000000000000000000001
  111100001000000000000001
  110100001000000000000001
  110000111000000000000001
  110100001000000000000001
  110111111000000000000001
  110000000000000000000001
  111111111000000000000001
  111111111111111111111111
