NO ./ressources/north.xpm
SO ./ressources/south.xpm
EA ./ressources/east.xpm

C 10,90,250
F 34,139,35


11111111111111000000000000001111111111
100000000000000000000001
100000000001110000000001
100000000001000000000001
100000000001000000000001
100000000001000000000001
100000000000000000 00001
1000000000000000N0000001
100000000000000000000001
100000111000000000000001
100000111000000000000001
100000111000000000000001
100000111000000000000001
100000111000000000000001
100000111000000000000001
100000111000000000000001
100000000000000000000001
100000000000000000000001
100000000000000000000001
111111111111111111111111