NO ./ressources/north.xpm
SO ./ressources/south.xpm
WE ./ressources/west.xpm
EA ./ressources/east.xpm

C 10,90,250
F 34,139,35

11111111111
11111011111
11111011111
11111011111
11111011111
11111N11111
10000000001