NO ./ressources/north.xpm
WE ./ressources/west.xpm
EA ./ressources/east.xpm





C 10,90,250
F 34,139,35
SO ./ressources/south.xpm

11111111111
11111000111
111110000011
11111011
11111011
11111N1
111111111