NO ./ressources/north.xpm
SO ./ressources/south.xpm
WE ./ressources/west.xpm
EA ./ressources/east.xpm

C 100,90,250
F 34,199,256


1111111111111
1000E00000011
1111111111111