NO ./ressources/north.xpm
SO ./ressources/south.xpm
WE ./ressources/west.xpm
EA ./ressources/east.xpm

C 10,90,250
F 34,139,35


alkjasdf

100000000000X00001111111
111111111111111111111111
100000000000000000000001
100000001100000000000001
100110001100000000000001
100000000000000000000001
100000110010000101010001
100000100010000000000001111111111
100000100010000100010000000000001
100000100010000000000001111111111
100000110110011111010001
100000000000010000000001
100000000000010010000001
100000000000010010000001
100000000101100000000001
100000110100000000000001
100000000000110000000001
100000000000001000000001
111100000000000000000001
11010000100000000000000111111111111111111
11000011100000000000000000000000000000111
110100001000000000000000000000000000001
110111111000000000000001111111111111111
110000000000000N00000001
1111111110000000000000011111
1111111111111111111111111111
