NO ./ressources/north.xpm
SO ./ressources/south.xpm
WE ./ressources/west.xpm
EA ./ressources/east.xpm

C 10,90,250
F 34,139,35


1111111111111
1000E00000011
1000000000011
1000S00000011
10000000N0011
1111111111111