NO ./ressources/north.xpm
WE ./ressources/west.xpm
EA ./ressources/east.xpm
SO ./ressources/south.xpm

C 225,67,100
F 220,90,60




111111111111111111111111
1011000001110000000000001
1001000000000000000000001
111111111011000001110000000000001
100000000011000001110111111111111
11110111111111011100000010001
11110111111111011101010010001
11000000110101011100000010001
10000000000000001100000010001
10000000000000001101010010001
11000001110101011111011110N0111
11110111 1110101 101111011111
111111111N111111