NO ./ressources/north.xpm
SO ./ressources/south.xpm
WE ./ressources/west.xpm
EA ./ressources/east.xpm

C 10,90,250
F 34,139,35


111111111111111111111111
100000000000000000000001
100000000001110000000001
100000000001000000000001
100000000001000000000001
100000000001000001
100000000000000N00000001
100000000000000000000001
100000000000000000000001
100000111000000000000001
100000111000000000000001
100000111000000000000001
100000111000000000000001
100000111000000000000001
100000111000000000000001
100000111000000000000001
100000000000000000000001
100000000000000000000001
100000000000000000000001
111111111111111111111111